----------Last session----------
Feb-09-2023
Isabella
----------


Beelzeboul
Ecbka
Leontiu		Leontiu
hiturnil	hiturnil
cijo		cijo
eaterfully	eaterfully
shoverencirch	shoverencirch
narhale		narhale
preklosus	preklosus
brtbrbt		brtbrbt
betbstb		betbstb
betetb		betetb
hbtefhbte	hbtefhbte
scrummya	scrummya
nyghfdy		nyghfdy
neerderrred	neerderrred
theberrer	theberrer
babbylenka	babbylenka
wadasdasd	wadasdasd
pectioniela	pectioniela
lamiconds	lamiconds
linguiettalies	linguiettalies
budgeasion	budgeasion
belusen
odeshing
palicianced
xylk		xylk
vurdazalak	vurdazalak
bookbox
floyans		floyans
hehehpidor	hehehpidor
inconsaf	inconsaf
milatoaq	milatoaq
PeretrenBog	PeretrenBog
nytdyh		nytdyh
nrhrhg		nrhrhg
acaer		acaer
affromty	affromty
guartwish
delierens	delierens
trementers	trementers
firehorsess	firehorsess
joristic	joristic
kajanchik	kajanchik
writmepof	writmepof
deironts	deironts
sineoutaor	sineoutaor
winnibler	winnibler
forcultankly	forcultankly
chaness		chaness
kodataringly	kodataringly
baylory		baylory
shmulamarced	shmulamarced
laboskiy	laboskiy
entsian		entsian
voyflenor	voyflenor
festeste	festeste
bliselevial	bliselevial
exharketraters	exharketraters
excien		excien
paffling	paffling
commention	commention
modecariialing	modecariialing
dorfultariant	dorfultariant
aminter		aminter
cilph		cilph
sazorl		sazorl
aplicorter	aplicorter
evativefo	evativefo
uverd		uverd
hamletive	hamletive
reassaneee	reassaneee
pulate		pulate
beachlorn	beachlorn
sianizeres	sianizeres
astrusaq	astrusaq
slembands	slembands
creachiness	creachiness
rohga		rohga
princallers	princallers
complizatics	complizatics
esamaf		esamaf
husbordes	husbordes
distardcvvxczd	distardcvvxczd
distarddsaa	distarddsaa
henspiconsed	henspiconsed
henspiconseda	henspiconseda
grobaq		grobaq
hhyyer		hhyyer
faquentlers	faquentlers
faquentler	faquentler
Nuxy9		Nuxy9
jhgrtdhjh	jhgrtdhjh
bnrdghn		bnrdghn
bfeabt		bfeabt
Kracivo		Kracivo
Gladdracula	Gladdracula
betsrrebs	betsrrebs
efrinter	efrinter
dsbxcvz		dsbxcvz
pendaytive	pendaytive
warlksaf	warlksaf
bgrdn		bgrdn
AlexYsik1	AlexYsik1
kyt40g		kyt40g
cizzbor		cizzbor
bezosloh1	bezosloh1
AlekseyPinchuk
Lexaclown1	Lexaclown1
Borodavan	Borodavan
Izabela2	Izabela2
Poteryashka	Poteryashka
FlaskO
Fionocha
Violon4eli
wsfdsfs		wsfdsfs
Luihuinz	Luihuinz
kozakkkk
Potnyak4
TarasShev4enko	TarasShev4enko
brytyr		brytyr
DenzzelCurry	DenzzelCurry
Potnyak3	Potnyak3
betrsebesb
Lecya
28dollars
byrby
Ysik4
btrby
berrrereb	berrrereb
treeemorer	treeemorer
giblinnerrr	giblinnerrr
Potnyak2	Potnyak2
grenereg	grenereg
nhilazh		nhilazh
kurrrvamatka	kurrrvamatka
babooooncka	babooooncka
Potnyak1	Potnyak1
berbergercha	berbergercha
HERRRTRUDA	HERRRTRUDA
Pinkypiered	Pinkypiered
Denzdromenzor	Denzdromenzor
Potnyak7	Potnyak7
grandpapich	grandpapich
BurBurBurger	BurBurBurger
Za4emP		Za4emP
60lvladaf	60lvladaf
Ky4eryaviu	Ky4eryaviu
Grandbob	Grandbob
Teeshort	Teeshort
Fiksik2		Fiksik2
aphofeya	aphofeya
Omgbug
Wowdence	Wowdence
ZxcYt		ZxcYt
171		171
Uhbwftyrj	Uhbwftyrj
befolking	befolking
Potnyak		Potnyak
6edolaga	6edolaga
5Ocent		5Ocent
IsabelO4ka	IsabelO4ka
GabrieO4ka	GabrieO4ka
imenting	imenting
mothodchront	mothodchront
aversonines	aversonines
gollera		gollera
miradasdf	miradasdf
headatist	headatist
suzew		suzew
poemess		poemess
infusidcienessa
voovsas		voovsas
actiongs	actiongs
catensualined	catensualined
writme		writme
Potnyaké	Potnyaké
Aokigahara1
Knucklez1
hhewr		hhewr

sianizeres	 I traded with this nickname but for some reason I couldn't find it in the list
